....#####..........
....#...#..........
....#%..#..........
..###..%##.........
..#..%.%.#.........
###.#.##.#...######
#...#.##.#####..**#
#.%..%..........**#
#####.###.#@##..**#
....#.....#########
....#######........