...................
....##########.....
....#**......#.....
....#**%..#..#.....
....#..#%##.##.....
....#.%.....#......
....#####.#.#......
......#.%.@.#......
......#.....#......
......#######......
...................