....#####..........
....#...#..........
....#...#..........
..###...##.........
..#......#.........
###......##########
#.........%..%..**#
#....%.......%..**#
#####.@.....%.%.**#
....#.....#########
....#######........